8 8
11111111
12001011
10000001
11101011
11001001
11011111
10000003
11111111